11111111111111111111111
100000001100100010101C1
10PC000010101010E001001
10111111100000101100101
10000000000000101C00001
11111111111111111111111