11111111111111111111111
1000000011CC100010101E1
10PC00001010101000001C1
10111111100000101000101
10000000000000101000001
11111111111111111111111