11111111111111111111111
1000000011C1100010101E1
10P00000101010100000101
10111111100000101000101
10000000000000101000101
11111111111111111111111