11111111111111111111111
1ECCCCCC110010001010101
10PCCCCC101010100001001
10111111100000101100101
10000000000000101000001
11111111111111111111111