111111111111111111111111
1ECCCCCC1100100010101011
11PCCCCC1010101000010011
101111111000001011001011
100000000000001010010011
111111111111111111111111