11111111111111111111111
10000000110010001010101
10PC000010101010E000101
10111111100000101000101
10000000000000101C00001
11111111111111111111111