11111111111111111111111111111111111
1E0000000000000C00000C0000000000011
11100101001000001010010000000101011
10100100101010100010010000000101011
1P00000000C00C000000000000000000C11
10100100101010100010010000000101011
10100100101010100010010000000101011
10100100101010100010010000000101011
10100100101010100010010000000101011
10100100101010100010010000000101011
10100100101010100010010000000101011
10100100101010100010010000000101011
10100100101010100010010000000101011
10100100101010100010010000000101011
10100100101010100010010000000101011
10100100101010100010010000000101011
10100100101010100010010000000101011
10100100101010100010010000000101011
10100100101010100010010000000101011
10100100101010100010010000000101011
10100100101010100010010000000101011
10100100101010100010010000000101011
10100100101010100010010000000101011
10100100101010100010010000000101011
10100100101010100010010000000101011
10100100101010100010010000000101011
10100100101010100010010000000101011
10100100101010100010010000000101011
10100100101010100010010000000101011
10100100101010100010010000000101011
10100100101010100010010000000101011
10100100101010100010010000000101011
10100100101010100010010000000101011
10100100101010100010010000000101011
10100100101010100010010000000101011
11111111111111111111111111111111111